0 0 0 0 0 0 0 0 0 0
9 0 0 0 0 0 0 0 0 9
11 0 0 2 0 3 0 2 0 11
11 0 0 3 0 0 0 0 0 11
10 0 12 13 6 7 0 0 0 10
0 0 15 14 6 7 0 0 0 0
0 0 0 0 6 7 0 0 0 0
0 0 2 0 6 7 0 0 0 0
9 0 0 0 6 7 0 0 0 9
11 0 0 3 6 7 0 0 0 11
11 0 0 0 6 7 3 0 0 11
10 0 0 0 6 7 0 2 0 10
0 0 0 0 6 7 0 2 0 0